NO ./texture/Clay_Brick.xpm
SO ./texture/Red_Brick.xpm
WE ./texture/Mossy_Stone.xpm
EA ./texture/Gravel.xpm

C 121,237,255
F 173,181,189

        1111111111111111111111111
        1000000000110000000000001
        1011000001110000001000001
        1001000000000000000000001
111111111011000001110000000000001
100000000011000001110111111111111
11110111111111011100000010001
11110111111111011101010010S01
11000000110101011100000010001
10001000000000001100000010001
10000000000000001101010000001
11000001110101011101011110001
11110111 1110101 101111010001
11110111 1110111 11111111000111111111
1000000111000001110000000000000000001
1000000000000000000000001111111111111
111111111111111111111111